# # # # # # # # # # # # # 
# E . . . . . = . . . . #
# . T . . . . = . . . . #
# . . # # # O = . . . . #
# . . # # # . = = . . . #
# . . # # ▲ ▲ ▲ = = = = #
# . . O . ▲ _ ▲ . . . . #
# = = = = ▲ ▲ ▲ # # . ~ #
# . . . = = . # # # . ~ #
# . . . . = . # # # . ~ #
# . . . . = . . . . . ~ #
# . . . . = . ~ ~ ~ ~ ~ #
# # # # # # # # # # # # #