# # # # # # # # # # # # # # # # # # 
# T . A . O . B . . . C . ▲ . . . # 
# # # # # # # # # # # # # # . E . #
# . _ A _ . . B . . _ C _ # . . . #
# # # # # # # # # # # # # # # # # #