# # # # # # # # # # # #
# . . . . T ▲ . . . B #
# . . . . . ▲ . A B . #
# = O = = = = = . . . #
# # ▲ _ . . . = ▲ ▲ ▲ #
# . . . . O A = . . . #
# # . . # # # = . . E #
# # # # # # # # # # # #