# # # # # # # # # # # # #
# . . . # . . . ▲ . . ~ #
# . T . # . A . ▲ . . ~ #
# . . . _ . . . ▲ . . ~ #
# . . . # # # # # # # # #
# . . . . . . . ▲ . . . #
# . O . . . A . ▲ . E . #
# . . . . . . . ▲ . . . #
# # # # # # # # # # # # #