# # # # # # # # # # # 
# . . . . . . . . . #
# . T . . ~ . . E . #
# . . . . . . . . . #
# # # # # # # # # # # 