# # # # # # # # # # # # #
# . . . . . . . # . . . #
# . T . . . . . # . A . #
# . . . . . . . # . . . #
# # _ # # ▲ _ ▲ # # _ # #
# ~ O ~ # . . . . . . . #
# ~ A ~ # . . . . . E . #
# ~ ~ ~ # . . . . . . . #
# # # # # # # # # # # # #