# # # # # # # # # # # # # # # # # # # # # # # # # # # # # # # # # #
# # # # # # # # # # # # ~ ~ ~ ~ ~ ~ ~ ~ ~ # # # # # # # # # # # # #
# # # # # # # # # # # # ~ ~ ~ ~ ~ ~ ~ ~ ~ # # # # # # # # # # # # #
# # . . . # # # # # # # ~ ~ ~ ~ ~ ~ ~ ~ ~ # # # # # # # # . . . # #
# # . T . . . . . . . . ~ ~ ~ ~ ~ ~ ~ ~ ~ . . . . . . . . . E . # #
# # . . . # # # # # # # ~ ~ ~ ~ ~ ~ ~ ~ ~ # # # # # # # # . . . # #
# # # # # # # # # # # # ~ ~ ~ ~ ~ ~ ~ ~ ~ # # # # # # # # # # # # #
# # # # # # # # # # # # ~ ~ ~ ~ ~ ~ ~ ~ ~ # # # # # # # # # # # # #
# # # # # # # # # # # # # # # # # # # # # # # # # # # # # # # # # #